...#.....#
.#.#.#.#.#
.#.#.#.#.#
.#...#.#*#
.#########
........o.
####.#####
.....#....
.###.####.
...#......
