o#........
.#####.##.
.......###
######.#*.
.......###
