o#........
.#####.##.
.......##.
######.#*.
.......###
